beneath the surface
10

| 1 |r8 | - | - |d8 | - | - | - | - | - |
| - | - | 2 | - | - | - | - | - | - | 1 |
| 1 | - | - | - | - | - | - | - | - | - |
| - |(6 | 1 | 1 |d8 |d8 | 1 | 1 |[6 | - |
| - | 1 | - | - | - | - | - | - | 1 | - |
| 1 | 5 | - | - | - | - | - | - | 5 | 1 |
| - | 3 | - | - |(7 |d8 | - | - |l8 | - |
| - | - | - | - |r8 | - | - | - |u8 | - |
| - | - | - | - | - | - | - | - | - | - |
| 5 | - | - | - | - |[7!| - | - | - | - |

==================NOTES==================