efficient transport
4

| - | 5 |d8 | - | - | - | - | - | - | - |
| - | - | - | 5 | - | - | 1 | - | - | - |
| 1 | - | - | 2 | - | - | - | 1 | - | - |
| - | - | - | - | - | - | - | - | - | - |
| - | 1 | - | - | 1 | 1 | - | - | - | - |
| - | - | - | - | - | - | - | - | - | - |
| - | - | - | - | - | - |r8 | - | - | - |
| - |r8 | - |d8 | - | - | - | 1 | 1 | - |
| 1 | - | 3 | - | - | - |u8 | - | - |l8 |
| 1 | - | - | - | - | - | - | - | - | 5 |

==================NOTES==================