haunted house
7

| - | - | - | 1 | - | - | - | - | - |l8 |
| - | - | - | - | - | - | - | - | - | - |
| - | - | 5 | - | - | - | 2 | - | - | - |
| - | - | - | - | - | - | - | - | - | - |
| - | - | - | - | - | - | - | - | - | - |
|r8 | - | - |[6 | - |d8 | - | - | - | - |
| - | 5 | - | - | - | - | - | - | - | - |
|(7 | 1 | 1 | 1 |(7 |[7 | 1 | 1 | 1 | - |
|u8 | - | - | - | - |[7 | - | - | 3 | - |
| - | - | - | - | - | 1 | 5 | 5 | 1 |(6 |

==================NOTES==================