hug the walls
17

| - | - | 1 | - | - | - | 2 | - | - | - |
| - | - | - | - | - | - | - | - | - | - |
| - | - | - | - | - | - | - | - | - | - |
| 5 | - | - | 1 | - | - | - | - | - |[7!|
| - | - | - | 3 | - | - | - | - | - | - |
| - | - | - | - | - | - | 5 | - | - | - |
| 1 | - | - | - |[7!| - | - | - | - | - |
|[6 | 1 | - | 1 | - | - | - | - | - | - |
| - | - | - | - | - | - | - | - | - | 1 |
| - | - | - | - | - | - | - | - | - | 1 |

==================NOTES==================
1 = wall
2 = player
3 = exit
4 = breakable
5 = deadly
6 = switch
7 = door