rail points
7

| - | - | - | - | - |[7!| - | - | - | - |
| - | - | 5 | - | - | - | - | - | - | - |
| 1 | - |(7!| - | 3 | - | - | - | - | - |
| 1 | - | - | - |r8 |r8 | - | - | 1 | - |
| - | - | - | - | - | - | - |(6 | - | - |
| - | - |u8 | - | 2 | - | - | - | - | 1 |
| - | - | - | - | - | - | - | 1 | - | - |
| - | - | - | - |[6 | - | - | - | - | - |
| - | - | - | - | - | - | - | - | - | - |
| 5 | - | - | - |r8 |u8 | - | - | - | 5 |

==================NOTES==================