the tube
3

|r8 | - |(6 |(7!| - | - | - |{6 |{7!|d8 |
| - | 1 | 1 | 1 | - | - | - | 1 | 1 |{6 |
|(7 | 1 | - | - | - | - | - | - | 1 |{7 |
|(6 | - | - | 1 | 1 | 1 | - | - | - | - |
| - | - | - | 1 | 1 | 1 | - | - | - |[6 |
| - |d8 | - | - | - | - | - | - | 1 |[7 |
| - | - | - | - | - | - | 1 | 1 | 1 | 3 |
| - | 2 | - |r8 | - |[6 |[7 | - | - |d8 |
| - | - | - | - | 1 | 1 | 1 | 1 | 1 | - |
|r8 |u8 | - | - |[7!|[6 | - | - | - |l8 |

==================NOTES==================