thwarted
6

| 5 | - | - | - | - | - | 3 | - | - | 5 |
| - | - | - | - | - | - |[7!| - | - | - |
| - | - | - | - | - | - |[6 | - | - | - |
| - | - | - | - | - | - | - | - | - | - |
| - | - | - | - | - |r8 | 2 | - | - | - |
| - | - | - | - | - | - |u8 | - | - | - |
| - | - | - | - | 1 | - | - | - | - | - |
| 1 | - | - | - | 1 | - | - | - | - | - |
| - | - | - | - | 1 | - | - | - | - | 1 |
| - | - | - | - |{7!|{6 | - | - | - |l8 |

==================NOTES==================