time to die
8

|5|-|-|1|-|-|-|-|-|4|
|-|1|-|-|-|-|-|-|-|-|
|-|-|-|5|-|-|-|-|-|-|
|5|-|-|-|-|-|-|-|-|-|
|3|-|-|-|-|-|-|1|-|-|
|5|-|4|-|-|2|1|-|-|-|
|-|-|-|-|-|-|-|-|-|-|
|-|-|-|-|-|-|-|-|1|5|
|-|-|-|-|-|1|-|-|-|-|
|-|-|5|5|-|-|-|-|-|-|

==================NOTES==================
