more switches
9

|1 |- |- |- |[6|- |- |- |5 |5 |
|- |- |- |- |- |4 |- |- |- |5 |
|- |- |- |- |- |- |1 |- |- |- |
|1 |- |- |- |- |- |- |- |- |- |
|1 |1 |- |1 |- |- |- |- |- |- |
|3 |[7|- |- |- |2 |- |- |- |4 |
|1 |1 |- |- |- |- |- |4 |- |(6| 
|- |- |- |- |1 |- |- |- |- |- |
|(7|1 |- |- |- |1 |- |- |- |- |
|[6|(7|- |- |- |- |- |- |- |- |

==================NOTES==================
[
(
{