let's do this
7

|-|-|-|-|-|-|-|-|-|-|
|-|-|-|-|-|-|-|-|-|-|
|-|-|-|-|-|-|1|-|-|-|
|-|1|-|-|-|-|-|-|-|-|
|1|-|-|-|-|2|-|-|-|-|
|-|-|-|-|3|-|-|-|-|-|
|1|-|-|-|-|-|-|1|-|-|
|-|-|-|-|-|1|-|-|-|-|
|-|-|1|-|-|-|-|-|-|-|
|-|-|-|-|-|-|-|-|-|-|

==================NOTES==================
