break it
7

|-|-|-|1|3|1|-|-|-|-|
|-|1|-|-|-|-|-|-|-|-|
|-|-|-|-|-|4|-|-|-|-|
|1|-|-|-|1|1|-|-|-|-|
|-|-|-|1|1|2|-|-|-|-|
|-|4|-|-|-|-|-|-|-|1|
|-|-|-|-|-|4|-|-|1|1|
|-|-|-|-|-|-|-|1|1|1|
|-|-|-|-|-|-|-|1|-|1|
|-|-|-|-|1|-|-|-|-|-|

==================NOTES==================
