another one
6

|-|1|-|-|-|-|-|-|-|-|
|-|-|-|-|1|-|-|-|-|-|
|1|-|-|-|-|1|-|-|-|-|
|-|-|-|-|-|-|-|-|-|-|
|-|-|-|-|2|-|-|-|1|-|
|-|-|-|-|-|-|-|-|-|-|
|-|-|-|-|-|-|-|-|3|-|
|-|-|-|1|-|-|-|-|-|-|
|-|-|-|-|-|-|-|-|-|-|
|-|-|-|-|-|-|-|-|-|-|

==================NOTES==================
