inverse doors galore
6

| 1 | - | - |{6 | 5 | - | - | - | - | - |
| - | - | - | - | 4 | - | 5 | - | - |(7!|
| - | - | - | - | - | - |(6 | - |(7!| 3 |
| 2 | - | - | - | - | 1 | - | - | - |(7 |
| - | - | - | 1 | - | - | - | - | - | - |
|[7!| 1 | - | - |{7!| - | - | - | - | - |
| - |[7!| - | - | - | - | 1 | - |{7!| - |
| - | 1 | - | 5 | 5 | 5 | - | 1 | - | - |
| - | - | - | - | - | - | - | - | - | - |
|[6 | - | - | - | - | - | - | - | - | - |

==================NOTES==================
[ = conn 1
( = conn 2
{ = conn 3

! = anti