electronics 101
7

|5|-|5|-|-|-|-|-|-|-|
|-|-|-|-|-|-|-|-|-|-|
|-|-|-|-|-|-|-|-|-|1|
|-|-|4|-|-|-|-|-|-|-|
|-|1|-|-|-|-|-|-|-|-|
|-|-|-|-|-|-|-|-|-|1|
|-|-|-|-|-|-|-|-|-|-|
|-|-|-|-|-|-|-|-|-|-|
|-|1|[7|1|1|1|1|1|1|1|
|3|1|2|-|-|-|-|-|-|[6|

==================NOTES==================
[
(
{