a bit harder
11

|3|-|1|2|-|-|-|-|1|-|
|1|-|-|-|-|-|-|-|-|-|
|-|-|-|-|-|-|-|-|-|1|
|-|-|-|-|-|-|-|-|-|-|
|-|-|-|-|-|1|-|-|-|-|
|-|-|-|-|1|-|-|-|-|-|
|-|-|-|-|-|-|-|-|-|-|
|-|-|-|-|-|-|-|-|-|1|
|-|-|-|-|-|-|-|-|-|-|
|-|-|1|-|-|-|1|-|-|-|

==================NOTES==================
