warehouse
5

|5  | - | - |d8 |1  | - | - | - | - |[7!|
|5  | - | - | - | - | - | - | - |1  | - |
|5  |2  | - | - | - | - | - | - | - | - |
|d8 | - | - | - |[6 | - | - | - | - | - |
| - | - |1  | - | - | - | - | - | - |5  |
| - | - | - | - | - | - |1  | - | - |5  |
| - |1  | - | - | - | - | - | - | - |5  |
| - | - | - | - | - | - | - | - | - |5  |
| - | - | - | - | - |3  | - | - | - |5  |
|r8 | - | - | - | - | - | - |u8 | - |5  |
