data entry
8

|5  | - | - | - | - | - | - | - | - | - |
| - | - | - | - | - |[7!| - | - | - | - |
| - | - | - | - | - | - | - | - |1  | - |
| - | - | - | - | - |(7!| - | - | - | - |
| - | - | - |1  |[7!|2  |(7 |3  | - | - |
| - |1  | - | - | - |[7 | - | - | - | - |
|[6 | - | - | - | - | - | - |1  | - | - |
| - | - | - | - |1  | - | - | - | - | - |
| - | - | - | - | - | - | - | - | - | - |
| - | - | - | - | - | - |1  | - | - | - |
