breakroom
8

| - | - | - | - | - |1  | - | - | - | - |
| - |2  |5  |3  | - | - | - | - | - | - |
| - | - | - |[10| - | - | - | - |1  | - |
| - | - | - | - | - | - | - | - |5  | - |
| - | - | - | - |5  | - | - | - |5  | - |
| - | - | - | - | - | - | - | - |5  | - |
| - |1  | - | - | - | - | - | - |5  | - |
| - | - | - |[9 | - | - | - | - |1  | - |
| - | - | - | - | - | - | - | - | - | - |
| - | - |1  | - | - | - | - | - | - | - |
