copywriting
7

| - | - | - |l8 | - |d8 | - | - | - | - |
| - | - | - | - | - |[6 | - | - | - | - |
| - | - | - | - |[7!| - | - | - | - |l8 |
| - | - |1  | - | - |2  | - |[6 | - |u8 |
| - | - | - | - | - |[7!| - | - | - | - |
| - | - | - | - | - |[6 | - | - | - | - |
|4  | - | - | - | - |u8 | - | - | - | - |
| - | - | - | - | - | - | - | - | - |1  |
| - | - | - | - | - | - | - | - | - | - |
| - | - | - | - | - | - | - |[7 | - |3  |
