boardroom
9

|[6 | - |1  |5  |5  |5  |3  |5  |5  |5  |
|5  | - | - | - | - | - | - | - | - |1  |
|5  | - |2  | - |1  | - | - | - | - |5  |
|1  | - | - | - | - | - | - | - | - |5  |
|5  | - | - |1  | - | - | - | - | - |5  |
|5  | - | - | - | - | - | - | - |1  |5  |
|5  | - | - | - | - | - | - | - | - |5  |
|5  | - | - | - | - | - | - |1  | - |5  |
|5  |[7!| - | - | - | - | - | - | - |5  |
|5  |5  |5  |5  |5  |5  |5  |5  |5  |5  |
