meteorology
10

| - | - | - | - | - |[7!|r8 | - | - |d8 |
| - | - | - | - | - | - | - | - | - | - |
| - | - | - | - | - | - | - | - | - | - |
| - |1  | - | - | - | - |[10| - | - | - |
| - | - | - | - |[9 | - | - | - | - | - |
| - | - | - | - | - | - | - | - | - |1  |
| - | - | - | - | - | - | - |1  | - | - |
| - |r8 | - | - | - | - | - | - | - | - |
| - | - | - |1  | - | - |3  |5  |2  | - |
| - |u8 | - | - |[6 | - | - | - | - | - |
