architectural
10

|3  |(7 |2  | - | - | - | - | - | - | - |
|1  |1  |1  |1  |1  |1  |1  |1  |1  | - |
| - | - | - | - | - | - | - | - |1  |[7!|
| - |1  | - | - | - | - | - | - | - | - |
| - | - | - | - | - | - | - | - | - | - |
| - | - | - | - |1  | - | - | - | - |[6 |
| - | - | - | - | - | - | - | - | - |1  |
| - | - | - | - | - |(6 | - | - | - | - |
|1  | - | - | - | - | - | - | - | - | - |
| - | - | - | - | - | - | - | - | - |1  |
